1111111111111
1001C000C0001
1000011111001
100P110000E01
1111111111111
