1111111111111
1001000C00001
1001000000001
100100E000001
10000C001C001
100000C000001
100P1100000E1
1111111111111
