1111111111111
1001C000C0001
1000011111001
100P1100E0E01
1111111111111
