1111111111111111111111111111111111
1E0000000000000C00000C000000000001
1010010100100000101001000000010101
1010010010101010001001000000010101
1P0000000C00C0000000000000000000C1
1010010100100000101001000000010101
1010010100100000101001000000010101
1010010100100000101001000000010101
1010010100100000101001000000010101
1010010100100000101000000000010101
1010010100000000001001000000010101
1010010100000000100001000000010101
1010010100000000101001000000010101
101001010010000010100C000000010101
101001010010000010100C000000010101
1010010100100000101001000000010101
1010010100C000C0101001000000010101
1010010100100000C0100C000000010101
1111111111111111111111111111111111
