111111111111111111111111
1E000000000C000000000001
101001010011000000010101
101001001011B0000B010101
1P0000000C000000000000C1
10100101001C000000010101
101001010011000000010101
1010010100C10B0000010101
10100101001C000000010101
111111111111111111111111